platformtiles.png
1 65 65
1 780 1214 65 65

000000000000000000000000000000000000000000000010S000000000000000000000000000SS00S0000
000000000000000000000000000000000000000000001000110000000000000S000000100011111111111
0000000000000000000000000000000000000000001000000000111111000111111110000000000000000
000000000000000000000000000000000S000000100000000000000000000000000000000000000000000
00000000000000000S0000000000011111111110000000000000000000000000000000000000000000000
0000000000000000111100010001000000000000000000000000000000000000000000000000000000000
0000000000100110000000000000000000000000000000000000000000000000000000000000000000000
00000000100000000000000000000000000000000000000000S0000000000000000000000000000000000
000000100000000000000S0000000000000000S0000000111111100000000000000000000000000000000
0000100S0000000000001111000111000111111110000000000000100S000000000B00000000B00000000
1111111111111111000000000000000000000000000000000000000111110000111111100011111111111
0000000000000000000000000000000000000000000000000000000000000000000000001000000000000
0000000000000000000000000000000000000000000000000000000000000000000000100000000000000
00000000P000000000000000001000000000000000B00000B0000000000B0000000010000000000000000
1111111111111111111111111111111111111111111111111111111111111111111111111111111111111
