platformtiles.png
1 65 65
1 780 1214 65 65

0000000000000000000000000000000000000000000000100000000000000000000000000000000000000
0000000000000000000000000000000000000000000010001100000000000000000000100011111111111
0000000000000000000000000000000000000000001000000000111111000111111110000000000000000
0000000000000000000000000000000000000000100000000000000000000000000000000000000000000
0000000000000000000000000000011111111110000000000000000000000000000000000000000000000
0000000000000000111100010001000000000000000000000000000000000000000000000000000000000
0000000000100110000000000000000000000000000000000000000000000000000000000000000000000
0000000010000000000000000000000000000000000000000000000000000000000000000000000000000
0000001000000000000000000000000000000000000000111111100000000000000000000000000000000
0000100000000000000011110001110001111111100000000000001000000000000B00000000B00000000
1111111111111111000000000000000000000000000000000000000111110000111111100011111111111
0000000000000000000000000000000000000000000000000000000000000000000000001000000000000
0000000000000000000000000000000000000000000000000000000000000000000000100000000000000
00000000P000000000000000001000000000000000B00000B0000000000B0000000010000000000000000
1111111111111111111111111111111111111111111111111111111111111111111111111111111111111
